############
#...#......#
..#.#.####.#
###.#......#
#....###.#..
####.#.#.#.#
#..#.#.#.#.#
##.#.#.#.#.#
#........#.#
##.###.###.#
#......#...#
#.##########
